1 1 1 1 1 1 1 1 1 1
1 1 0 k 0 k 0 0 3 1
1 0 k 2 k 0 k 1 d 1
1 p 0 k 0 k k 3 t 1
1 0 k 2 0 0 0 0 1 1
1 1 1 0 0 k 1 1 1 1
1 1 1 1 1 1 1 1 1 1