1111111111111111
1000000000010011
1000000000010001
1000111001110031
1000100000000011
1000100000000011
1000111001110011
1200000001000001
1000000001000001
1111111111111111